@.......#..........~
@~..##...@#......#..
....@@....^.#...#^..
....~^..~.......~..~
.....~.@~..##.^^....
^..@.#.....@~.......
##..#...^....#......
^......#~..~.~.~.#..
.#.^..#.....~..~....
..........~~~..~....
~.................#.
...~........#..#....
.#.#...#..~....~....
.....~.#...^~#...~..
....................
..#~..#~#.......~..#
.~...#....#.~.......
.#..#...~.#.#..~.#.~
^#.....~..~#^.^.~^..
.....#..~...........
